%%%%%%%%%%%%%%%%%%%%%%%%%%%%%%%%%%%%%%%%%
%.%           %             %           %
% %%%%% %%%%% %%% %%%%% %%% % %%% %%%%%%%
%         %         %   %       %       %
%%%%%%%%% %%%%% %%%%%%% % % %%%%%%%%% %%%
%     %     %   %         %     %   %   %
% %%% % %%% % %%% %%%%%%%%% %%%%% %%%%% %
%   %     % %               %         % %
% % %%% %%%%%%% %%%%%%%%% %%% % %%%%%%% %
% %   %     %     %   %   %   %         %
%%% %%%%%%%%%%%%%%% % % %%% %%%%%%%%%%%%%
%     %         %   % %   %             %
%%% %%%%% %%%%% % % %%% %%%%%%%%%%%%%%% %
%   %         % % %                     %
% %%% %%%%%%%%% % % %%%%%%%%% %%%%%%%%%%%
%     %         % %     %         %     %
%%%%%%%%% %%%%%%% %%%%%%%%% %%%%% % %%%%%
%             %         %       %       %
% %%% %%%%%%%%% %%%%% %%%%% % % % %%% % %
%   %             %   %         %     %P%
%%%%%%%%%%%%%%%%%%%%%%%%%%%%%%%%%%%%%%%%%
