%%%%%%%%%
%2..%dc.%
%.%.%%%.%
%.%.1  b%
%.%%P%%.%
%3 89..a%
%.%.%%%%%
%4.5..67%
%%%%%%%%%